1 1 1 1 1 1 1 1 1 6
2 3 3 3 3 3 3 3 3 6
2 4 4 3 3 3 3 5 5 6
2 4 4 3 3 3 3 5 5 6
2 3 3 3 3 3 3 5 5 6
2 3 3 3 3 3 3 3 3 6
2 3 3 3 3 3 3 3 3 6
2 7 7 3 3 3 3 3 3 6
2 7 7 3 3 3 3 3 3 6
2 8 8 8 8 8 8 8 8 8
